
 
 Credit			
 			
 Bradford 	Bill	Vice President	
 Brackett	Debbie	Sr Director	
 Rohauer	Tanya	Sr Director	
 Nelson	Rod	Director	
 Sacks	Ed	Manager	
 Williams	Jay	Manager	
 McGinnis	Stephanie	Manager	
 Reasoner	Monica	Sr Analyst	
 Radous	Paul	Manager	
 Suttle	John	Manager	
 Sononstine	Max	Sr Analyst	
 			
 Vanek	Darren	Analyst	
 Wilhite	Jane	Sr Analyst	
 Conwell 	Wendy	Sr Analyst	
 Brown	Kortney	Sr Analyst	
 Espinoza	Veronica	Analyst	
 			
 			
 
 
 Louise Kitchen
 Chief Operating Officer
 Enron Americas
 Tel:  713 853 3488
 Fax: 713 646 2308