
      yet signed up and would like to participate
 Mime-Version: 1.0
  Content-Transfer-Encoding: 7bit
 X- X- X- X-b X-Folder: \ExMerge - Scholtes, Diana\Sent Items
 X-Origin: SCHOLTES-D
 X-FileName: 
 
 please sign me up for myself and spouse.
 
 Thank you
 Diana Scholtes
 
  
     
 
 Flu Shot Clinic Sponsored By Enron
 
 When:  Tuesday, November 13, 2001
 				        Time: 8:30 a.m.-10:30 a.m.
 				        Where:  Enron 3WTC Office
 					Who: Enron employees, spouses and domestic partners are 							welcome to participate
 
 Please sign up, via email to Josie Jarnagin,  by Tuesday, November 6, 2001.
 
 The following is a list of employees already signed up for the clinic.
 
 			
 Last Name	First Name	Quantity	
 Alport	Kysa	1	
 Axford	Kathy	1	
 Belden	Tim	2	
 Bruce	James	1	
 Calger 	Chris	1	
 Clark	Ed	2	
 Cutsforth	Diane	1	
 Davidson	Debra	1	
 Driscoll	Michael	1	
 Elafandi	Mo	1	
 Eriksson	Fredrik	1	
 Fuller	Dave	1	
 Gilbert	Jim	2	
 Gustafson	Mollie	1	
 Hall	Steve	1	
 Hall	Erin	1	
 Malowney	John	1	
 Mays	Wayne	1	
 Meyer	Jim	1	
 Miles	Darryl	2	
 Mumm	Chris	1	
 Nalluri	Susmitha	2	
 Nelson	Kourtney	1	
 Oh	John	1	
 Rance	Susan	2	
 Rasmussen	Dale	1	
 Semperger	Cara	2	
 Sheppard	Kathryn	1	
 Shields	Jeff	2	
 Slaughter	Jeff	2	
 Soderquist	Larry	1	
 Van Gelder	Jon	2	
 Villeggiante	Theresa	1	
 Wente	Laura	1	
 Williams	Bill	1	
 Williams III	Bill	1	
 Yoder	Christian	2	